16 17 0 0 0 0 0 0 0 0 0 0 0 0 0 0 0
18 19 0 0 0 0 0 0 0 0 0 0 0 0 0 0 0
1 1 1 1 1 1 1 1 1 1 1 1 1 1 0 0 0
0 0 0 0 0 5 5 7 9 0 11 5 3 9 7 11 5
0 0 0 0 0 6 6 8 10 0 12 6 4 10 8 12 6
0 0 0 1 1 1 1 1 1 1 1 1 1 1 1 1 1
9 5 3 11 7 0 7 11 5 9 9 0 0 5 0 0 0
10 6 4 12 8 0 8 12 6 10 10 0 0 6 0 0 0
1 1 1 1 1 1 1 1 1 1 1 1 1 1 0 0 0
0 0 0 3 3 5 7 9 9 11 9 3 0 0 0 5 5
0 0 0 4 4 6 8 10 10 12 10 4 13 0 0 6 6
0 0 0 1 1 1 1 1 1 1 1 1 1 1 1 1 1
11 11 7 0 0 0 3 9 5 7 3 11 0 0 0 0 0
12 12 8 13 0 0 4 10 6 8 4 12 0 0 0 0 0
1 1 1 1 1 1 1 1 1 1 1 1 1 1 0 0 0 
0 0 0 3 0 5 5 7 9 0 11 5 3 9 7 11 5
0 0 0 4 0 6 6 8 10 0 12 6 4 10 8 12 6
0 0 0 1 1 1 1 1 1 1 1 1 1 1 1 1 1
0 0 0 3 3 5 7 9 9 11 9 3 0 0 0 0 0
13 0 0 4 4 6 8 10 10 12 10 4 0 0 0 0 0
1 1 1 1 1 1 1 1 1 1 1 1 1 1 0 0 0
0 0 0 11 7 0 7 11 5 9 9 0 0 5 0 0 0
0 0 0 12 8 0 8 12 6 10 10 0 0 6 0 0 0
0 0 0 1 1 1 1 1 1 1 1 1 1 1 1 1 1
11 11 7 0 0 0 3 9 5 7 3 11 0 0 0 0 0
12 12 8 0 0 0 4 10 6 8 4 12 0 0 0 0 0
1 1 1 1 1 1 1 1 1 1 1 1 1 1 0 0 0
0 0 0 0 0 0 0 0 0 0 0 0 0 0 0 0 0
0 0 0 0 0 0 0 13 13 0 0 0 0 0 0 0 0
0 0 0 1 1 1 1 1 1 1 1 1 1 1 1 1 1
9 5 3 11 7 0 7 11 5 9 9 0 0 0 0 0 0
10 6 4 12 8 0 8 12 6 10 10 0 0 0 0 0 0
1 1 1 1 1 1 1 1 1 1 1 1 1 1 0 0 0
0 0 0 3 3 5 7 9 9 11 9 3 0 0 0 5 5
0 0 0 4 4 6 8 10 10 12 10 4 0 0 0 6 6
0 0 0 1 1 1 1 1 1 1 1 1 1 1 1 1 1
7 11 0 0 0 0 0 0 14 0 0 0 0 0 0 0 0
8 12 0 0 0 0 0 0 15 13 13 0 0 0 0 0 0
1 1 1 1 1 1 1 1 1 1 1 1 1 1 0 0 0
0 0 0 0 0 0 5 5 3 11 0 0 0 0 0 0 0
0 0 0 0 0 13 6 6 4 12 0 0 0 0 0 0 0
0 0 0 1 1 1 1 1 1 1 1 1 1 1 1 1 1
11 11 7 14 0 0 3 9 5 7 3 11 0 0 0 0 0
12 12 8 15 0 0 4 10 6 8 4 12 0 0 0 0 0
1 1 1 1 1 1 1 1 1 1 1 1 1 1 0 0 0
0 0 0 0 0 0 14 14 0 0 0 0 0 0 0 0 14
2 0 0 0 0 0 15 15 13 13 0 0 0 0 13 13 15
1 1 1 1 1 1 1 1 1 1 1 1 1 1 1 1 1